11111111111111111111111111111111111111
100100000000000C00000000000000010000C1
10000000000000000000000000000000000001
10000000111110000000000011100001111001
10000000000000000000000000000000000001
10000000000000000000000000000000000001
1P00CC0000000000000000000000C11EC00001
10000000111110000000111000000011111001
1000000010C000000000000000000000000001
10000000100000000000000000000000000001
10000000100000000000000000000000000001
11111111111111111111111111111111111111
11111111111111111111111111111111111111
100100000000000C00000000000000010000C1
10000000000000000000000000000000000001
10000000111110000000000011100001111001
1P00CC0000000000000000000000C11EC00001
10000000111110000000111000000011111001
1000000010C000000000000000000000000001
10000000100000000000000000000000000001
10000000100000000000000000000000000001
11111111111111111111111111111111111111
11111111111111111111111111111111111111