111111111111111111111111111111111111111111
100100000000000C000000000000000100000000C1
100000000000000000000000000000000000000001
100000001111100000000000111000000011111001
100000000000000000000000000000000000000001
100000000000000000000000000000000000000001
1P00CC00000000000000100000000000C11EC00001
100000001111100000000000111000000011111001
1000000010C0100000000000000000000000000001
100000001000100000000000000000000000000001
100000000000100000000000000000000000000001
111111111111111111111111111111111111111111