1111111111111111111111111111111111111
100100000000000C0000000000000001000C1
1000000000000000000000000000000000001
1000000011111000000000001110000111001
1000000000000000000000000000000000001
1000000000000000000000000000000000001
1000CC000000000000000000000011EC00001
1000000011111000000011100000011111001
1000000010C00000000000000000000000001
1000000010000000000000000000000000001
1000000010000000000000000000000000001
1111111111111111101111111111111111111
1111111111111111101111111111111111111
100100000000000C0000000000000010000C1
1000000000000000000000000000000000001
1000000011111000000000011100001111001
1P00CC000000000000000000000C110C00001
1000000011111000000111000000011111001
1000000010C00000000000000000000000001
1000000010000000000000000000000000001
1000000010000000000000000000000000001
1111111111111111111111111111111111111