11111111111111111111
100100000000000010E1
10001000000000000001
10000000111110001111
10000000000000000001
11111111111011111011
1P000000000010011011
10000001111000001111
10000000110110000111
100000CC100010000001
10000000000010000011
11111111111111111110