11111111111111111111
100100000000000C0001
10000000000000000001
10000000111110001111
10000000000000000001
11111111011111111011
1P00CC00000010C11E11
10000001111000001111
1000000011C110000111
10000000100010000001
10000000000010000001
11111111111111111111