1111111111111
10010000000C1
1000C11111001
1P0011E1C1001
10C10001010C1
10010111000C1
10010000010C1
1111111111111